Ang : ang
relasyon : relasyon
ay : ay
parang : para
pagsusuot : suot
ng : ng
cocktail : ocktail
dress : dress
at : at
rubber : rubbed
shoes : hoes
ng : ng
sabay : sabay
Magkaiba : Magkaiba
man : man
babagay : bagay
pa : pa
rin : rin
yan : yan
depende : depende
sa : sa
nagdadala : dala
Minsan : Minsan
daw : daw
kakapagod : pagod
magmahal : mahal
minsan : minsan
masaya : saya
tapos : tapos
may : may
oras : oras
na : na
iiyak : iyak
ka : ka
Sabi : Sabi
nila : nila
magsasawa : sawa
din : din
ako : ako
Sabi : Sabi
ko : ko
di : di
totoo : totoo
yun : yun
Alam : Alam
mo : mo
bakit : bakit
kailan : kailan
ba : ba
nagsawa : sawa
ang : ang
taong : taong
nagmamahal : mahal
ng : ng
totoo : totoo
